TTTTTTTTTTTTTTTTTTTT
T         R       RT
T R        G       T
T     G         R  T
T        R         T
T     R        R   T
T R                T
T  TTTTT     R     T
T   R  T           T
T      T R     R   T
TTTTTTTTTTTTTTTTTTTT